##################################################
#...........#....................................#
#.#######.#.##########.##########################.#
#.#.....#.#.#........#.#......................#.#.#
#.#.###.#.#.#.######.#.#.####################.#.#.#
#.#.#...#.#.#.#....#.#.#.#..................#.#.#.#
#.#.#.###.#.#.#.##.#.#.#.#.##############.#.#.#.#.#
#.#.#.#...#.#.#..#.#.#.#.#.#............#.#.#.#.#.#
#.#.#.#.###.#.#.#.#.#.#.#.#.##########.#.#.#.#.#.#
#.#.#.#.#...#.#.#.#.#.#.#.#.#........#.#.#.#.#.#.#
#.#.#.#.#.###.#.#.#.#.#.#.#.#.######.#.#.#.#.#.#.#
#.#.#.#.#.#...#.#.#.#.#.#.#.#.#....#.#.#.#.#.#.#.#
#.#.#.#.#.#.###.#.#.#.#.#.#.#.#.##.#.#.#.#.#.#.#.#
#.#.#.#.#.#.#...#.#.#.#.#.#.#.#..#.#.#.#.#.#.#.#.#
#.#.#.#.#.#.#.###.#.#.#.#.#.#.#.#.#.#.#.#.#.#.#.#.#
#.#.#.#.#.#.#.#...#.#.#.#.#.#.#.#.#.#.#.#.#.#.#.#.#
#.#.#.#.#.#.#.#.###.#.#.#.#.#.#.#.#.#.#.#.#.#.#.#.#
#.#.#.#.#.#.#.#.#...#.#.#.#.#.#.#.#.#.#.#.#.#.#.#.#
#.#.#.#.#.#.#.#.#.###.#.#.#.#.#.#.#.#.#.#.#.#.#.#.#
#.#.#.#.#.#.#.#.#.#...#.#.#.#.#.#.#.#.#.#.#.#.#.#.#
#.#.#.#.#.#.#.#.#.#.###.#.#.#.#.#.#.#.#.#.#.#.#.#.#
#.#.#.#.#.#.#.#.#.#.#...#.#.#.#.#.#.#.#.#.#.#.#.#.#
#.#.#.#.#.#.#.#.#.#.#.###.#.#.#.#.#.#.#.#.#.#.#.#.#
#.....#...#.#.#.#...#.....#.#.#.#.#.#.#.#...#.....#
##################################################