#####################################################################################
#...........B.......................................................................#
#...................................................................................#
#...................................................................................#
#..................&................................................................#
#.......B...........................................................................#
#............................&......................................................#
#...............&...................................................................#
#...................................................................................#
#...................................................................................#
#...................................................................................#
#...................................................................................#
#...................................................................................#
#...................................................................................#
#...................................................................................#
#...................................................................................#
#...................................................................................#
#...................................................................................#
#...................................................................................#
#...................................................................................#
#...................................................................................#
#...................................................................................#
#...................................................................................#
#...................................................................................#
#####################################################################################